B2,1,2,'A'
B3,1,3,'A'
B4,1,4,'A'
B1,1,1,'A'
F3,2,3,'A'
F6,2,6,'A'
F7,2,7,'A'
F1,2,1,'A'
F2,2,2,'A'
F5,2,5,'A'
F4,2,4,'A'
